##############
#          e #
#   ##### #  #
#   e   # #  #
# # ##### #  #
#   #  e  #  #
#   # #####  #
#   #  e     #
#   #######  #
# p          #
##############

:Kill all robots
:Find control panel
:Escape
