##############
#            #
#   ##### #  #
#       # #  #
# # ##### #  #
#   #     #  #
#   # #####  #
#   #e    #  #
#   #######  #
#  p e       #
##############
